33333333333333333
31111101111411113
34211111111211113
31111111111111243
33333333333333333