33333333333
31111111113
31111111113
30111111113
33333333333