33333333333333333
31111111111411113
34211111111211113
30111111111111243
33333333333333333